15:15
00 20 30 21 29 21 30 21 28 30 26 30 27 30 26 
00 24 34 24 36 24 37 24 39 32 32 00 00 00 00 
00 24 82 24 84 24 85 24 32 32 00 00 00 00 00 
00 24 82 24 84 24 85 24 32 00 00 00 00 00 00 
00 24 82 24 84 24 85 24 00 00 00 00 00 00 00 
00 24 82 24 84 24 85 24 00 00 00 00 00 00 00 
00 25 00 25 00 25 00 25 00 00 18 00 00 00 18 
00 00 00 00 00 00 00 00 00 00 00 16 00 16 00 
00 00 00 00 00 00 00 17 00 00 00 00 38 00 00 
00 00 00 00 00 00 00 00 00 00 00 16 00 16 00 
00 24 00 24 00 24 00 00 00 00 18 00 00 00 18 
00 24 81 24 83 24 00 00 00 00 00 00 00 00 00 
00 24 81 24 83 24 32 00 50 00 00 00 00 00 00 
00 24 33 24 35 24 00 97 00 00 17 00 00 00 00 
00 22 26 27 26 27 26 26 29 26 26 28 28 26 26 