12:12
49 0 0 0 0 0 0 0 0 0 0 0 
17 0 17 0 17 0 17 17 17 17 0 0 
0 0 0 0 17 32 17 0 0 17 0 0 
32 0 0 0 17 32 17 0 0 17 0 0 
0 0 0 0 17 32 17 0 0 17 0 0 
0 0 0 0 17 17 17 0 0 17 0 0 
0 0 0 0 0 0 0 0 0 17 0 0 
0 18 32 18 0 0 0 0 0 17 0 0 
0 18 18 18 0 0 18 0 0 17 0 0 
0 0 0 0 0 0 0 0 0 17 0 0 
32 17 17 17 17 17 17 17 17 17 32 0 
32 0 48 0 0 0 0 0 0 0 0 0 
